=_________=====
=__________#__=
=__=*====__==#=
=_X=!=!*=__=@*=
=_==#==*=_=====
=_=***=*=X=XT=K
=_=*!*=*===__=_
=_=***=*=**_==_
=___MX=***=_==_
W____________**
-
9 5 2 3
5 9 11 5
