================
=__^^___***____=
=_______*@*____=
=_______***____=
=______________=
=___MWTK_______=
================