^________________________
__________======_________
K_________****X=_________
__________======_________
_^________!##@=__________
___=X=____!====__________
___=T=__M__W_____________
___===_________________^_
=========================
-
2 14 5 4